SO textures/wall_2.xpm
NO textures/wall_2.xpm
WE textures/wall_2.xpm
EA textures/wall_2.xpm
F   255,255,255
C 0,0,0

        1111111111111111111111111
        1000000000110010010010101
        1011001001110010010011101
        1001001000000010010000001
111111111011001001110010010001101
100000000011000001110111111111111
11110111111111011100000010001
11110111111111011101010010001
11000000110101011100000000001
1111100N000000000000010010001
11111111100000001101010010001
        11100001110101011111111111111
        1111111111111111111111 111111